




EA ./textures/wall4.png 
          
SO ./textures/wall2.png

WE ./textures/wall3.png         

NO ./textures/wall1.png

C 135,206,250

F 100,140,60






    



    1
    1
    11
                                            11111                                        
                                           1100011111111           111111111
    1111111111111111                       1100000000001            100000001
    10000000000000001111111111111111111111111100000000001111111111111111110111111111111111111111111111111111
    10000000000000000000000000000000000000000000000000000000000000000000000101010000000000000000000000000001
    10000000000000000000000000000000000000000000000111100000000000000000010100010000000000000000000000000001
    1000000000000000000000000S000000000000000111110000111011110000000000010101010000000000000000000000000001
    10000000000000000000000000000000000000000000010000000010000000000000010001000000000000000000000000000001
    11111111111111111111111111111111111111111111111111111111111111111111111111111111111111111111111111111111
                                                                                                                1
                                                                                                                1
                                                                                                                1
                                                                                                                1
                                                                                                                1
                                                                                    1
1
1
1
1000000