C 135,206,250
EA ./textures/wall4.png

WE ./textures/wall3.png

SO ./textures/wall2.png

NO ./textures/wall1.png

F 100,140,60



                                            11111
                                            1100011111111
    11111111111111111                       1100000000001
    10000000000000001111111111111111111111111100000000001111111111111111111111111111111111111111111111111111
    1000000000000000000000000000000000000000000000E000000000000000000000000101010000000000000000000000000001
    10000000000000000000000000000000000000000000000111100000000000000000010100010000000000000000000000000001
    10000000000000000000000000000000000000000111110000111011110000000000010101010000000000000000000000000001
    10000000000000000000000000000000000000000000010000000010000000000000010001000000000000000000000000000001
    11111111111111111111111111111111111111111111111111111111111111111111111111111111111111111111111111111111